0,0,0,0,0,0,0,0,0,0,0,0
0,0,0,0,0,0,0,0,0,0,0,0
0,0,0,0,0,0,0,0,0,0,0,0
0,0,0,0,0,0,0,0,2,2,0,0
0,0,0,0,0,0,0,2,0,0,2,0
0,0,2,2,0,0,0,2,0,0,2,0
0,2,0,0,2,0,0,0,2,2,0,0
0,2,0,0,2,0,0,0,0,0,0,0
0,0,2,2,0,0,2,2,0,0,0,0
0,0,0,0,0,2,0,0,2,0,0,0
0,0,0,0,0,2,0,0,2,0,0,0
1,6,1,6,1,0,2,2,0,6,1,6
