0,0,0,0,0,0,0,0,0,0,0,0
0,0,0,0,0,0,0,0,0,0,0,0
0,0,0,0,0,0,0,0,0,0,0,0
0,0,0,0,0,0,0,0,0,0,0,0
0,0,0,0,0,0,0,0,0,0,0,0
0,0,0,0,0,1,1,0,0,0,0,0
0,0,0,1,1,3,3,1,1,0,0,0
0,0,6,1,3,6,6,3,1,6,0,0
0,0,1,3,6,3,3,6,3,1,0,0
0,0,0,1,3,6,6,3,1,0,0,0
0,0,1,1,1,3,3,1,1,1,0,0
6,6,1,6,6,1,1,6,6,1,6,6
