0,0,0,0,0,0,0,0,0,0,0,0
0,0,0,0,0,0,0,0,0,0,0,0
0,0,0,0,0,0,0,0,0,0,0,0
0,0,0,0,0,0,0,0,0,0,0,0
0,0,0,0,0,0,0,0,0,0,0,0
0,0,0,0,0,0,0,0,0,0,0,0
0,4,0,0,0,4,0,0,0,4,0,0
4,6,4,0,4,6,4,0,4,6,4,0
0,4,0,0,0,4,0,0,0,4,0,0
0,5,0,0,0,5,0,0,0,5,0,0
0,5,0,0,0,5,0,0,0,5,0,0
6,5,6,6,6,5,6,6,6,5,6,6
