0,0,0,0,0,0,0,0,0,0,0,0
0,6,6,6,0,6,6,6,0,6,6,6
3,3,3,3,2,2,2,2,4,4,4,4
0,0,0,0,0,0,0,0,0,0,0,0
0,0,0,0,0,0,0,0,0,0,0,0
0,0,0,0,0,0,0,0,0,0,0,0
0,0,0,0,0,0,0,0,0,0,0,0
0,0,0,0,0,0,0,0,0,0,0,0
0,1,0,1,0,1,0,1,0,1,0,1
1,0,1,0,1,0,1,0,1,0,1,0
0,3,0,3,0,3,0,3,0,3,0,3
0,0,0,0,0,0,0,0,0,0,0,0
