0,0,0,0,0,0,0,0,0,0,0,0
0,0,0,0,0,0,0,0,0,0,0,0
0,0,0,0,0,0,0,0,0,0,0,0
0,0,0,0,0,0,0,0,0,0,0,0
0,0,0,0,0,0,0,0,0,0,0,0
0,0,0,0,0,0,0,0,0,0,0,0
0,0,0,0,0,3,3,0,0,0,0,0
0,0,3,3,3,5,5,3,3,3,0,0
0,3,3,5,5,2,2,5,5,3,3,0
3,3,5,2,2,4,4,2,2,5,3,3
3,5,2,2,4,0,0,4,2,2,5,3
3,5,2,4,0,0,0,0,4,2,5,3
