0,0,0,0,0,0,0,0,0,0,0,0
0,0,0,0,0,0,0,0,0,0,0,0
0,0,0,0,0,0,0,0,0,0,0,0
0,0,0,0,0,0,0,0,0,0,0,0
0,0,0,0,0,0,0,0,0,0,0,0
5,0,0,0,0,0,0,0,0,0,0,0
3,5,2,0,2,0,0,0,0,0,0,0
0,0,4,3,3,2,0,0,0,0,0,0
0,0,0,0,0,0,0,0,0,0,0,3
0,0,0,0,0,0,0,3,0,5,2,2
0,0,0,0,0,0,4,4,2,5,0,0
0,0,0,0,0,3,0,0,0,0,0,0
